30
60
   XXXXXXXXXXXXXXXXXXXXXXXXXXXXXXXXXXXXXXXXXXXXXXXXXXXXXXXXX
XX XXXXXXXXXXXXXXXXXXXXXXXXXXXXXXXXXXXXXXXXXXXXXXXXXXXXXXXXX
XX              XXXXXXXXXXXXXXXXXXXXXXXXXXXXXXXXXXXXXXXXXXXX
XXXXXXXXXXXXXXX XXXXXXXXXXXXXXXXXXXXXXXXXXXXXXXXXXXXXXXXXXXX
XXXXXXXXXXXXXXX XXXXXXXXXXXXXXXXXXXXXXXXXXXXXXXXXXXXXXXXXXXX
XXXXXXXXXXXXXXX XXXXXXXXXXXXXXXXXXXXXXXXXXXXXXXXXXXXXXXXXXXX
XXXXXXXXXXXXXXX  XXXXXXXXXXXXXXXXXXXXXXXXXXXXXXXXXXXXXXXXXXX
XXXXXXXXXXXXXXXX XXXXXXXXXXXXXXXXXXXXXXXXXXXXXXXXXXXXXXXXXXX
XXXXXXXXXXXXXXXX XXXXXXXXXXXXXXXXXXXXXXXXXXXXXXXXXX XXXXXXXX
XXXXXXXXXXXXXXXX XXXXXXXXXXXXXX             XXXXXX  XXXXXXXX
XXXXXXXXXXXXXXXX XXXXXXXXXXXXXX XXXXXXXXXXX XXXXXX XXXXXXXXX
XXXXX            XXXXXXXXXXXXXX XXXXXXXXXX  XXXXXX XXXXXXXXX
XXXXXX XXXXXXXXX XXXXXXXXXXXXXX XXXXXXXXXX XXXXXXX XXXXXXXXX
XXXXXX  XXXXXXXX  XXXXXXXXXXXXX XXXXXXXXXX XXXXXXX XXXXXXXXX
XXXXXXX XXXXXXXXX XXXXXXXXXXXXX XXXXXXXXXX XXXXXX  XXXXXXXXX
XXXXXXX XXXXXXXXX  XXXXXXXXXXXX XXXXXXXXXX        XXXXXXXXXX
XXXXXXX XXXXXXXXXX   XXXXXXXXXX XXXXXXXXXXXXXXXXXXXXXXXXXXXX
XXXXXXX XXXXXXXXXXXX   XXXXXXXX XXXXXXXXXXXXXXXXXXXXXXXXXXXX
XXXXXXX XXXXXXXXXXXXXX   XXXXXX XXXXXXXXXXXXXXXXX   XXXXXXXX
XXXXXXX XXXXXXXXXXXXXXXX  XXXXX XXXXXXXX          X  XXXXXXX
XXXXXXX XXXXXXXXXXXXXXXXX   XXX          XXXXXX XXXX  XXXXXX
XXXXXXX XXXXXXXXXXXXXXXXXXX  XXXXXXXXXXXXXXXXX XXXXXX  XXXXX
XXXXXXX  XXXXXXXXXXXXXXXXXXX   XXXXXXXXXXXXXXX XXXXXXX  XXXX
XXXXXXXX           XXXXXXXXXXX   XXXXXXXXXXXXX XXXXXXXX XXXX
XXXXXXXXXXXXXXXXXXXXXXXXXXXXXXXX    XXXX       XXXXXXXX XXXX
XXXXXXXXXXXXXXXXXXXXXXXXXXXXXXXXXXX      XXXXXXXXXXXXXX  XXX
XXXXXXXXXXXXXXXXXXXXXXXXXXXXXXXXXXXXXXXXXXXXXXXXXXXXXXXX XXX
XXXXXXXXXXXXXXXXXXXXXXXXXXXXXXXXXXXXXXXXXXXXXXXXXXXXXXXX XXX
XXXXXXXXXXXXXXXXXXXXXXXXXXXXXXXXXXXXXXXXXXXXXXXXXXXXXXXX XXX
XXXXXXXXXXXXXXXXXXXXXXXXXXXXXXXXXXXXXXXXXXXXXXXXXXXXXXXX   D