30
60
 XXXXXXXXXXXXXXXXXXXXXXXXXXXXXXXXXXXXXXXXXXXXXXXXXXXXXXXXXXX
 XXXXXXXXXXXXXXXXXXXXXXXXXXXXXXXXXXXXXXXXXXXXXXXXXXXXXXXXXXX
                              XXXX        XXXXXXXXXXXXXXXXXX
XXXXXXXXXXXXXXX XXXXXXXXXXXXXXXXXX XXXXXXXXXXXXXX XXXXXXXXXX
XXXXXXXXXXXXXXX XXXXXXXXXXXXXXXXXX XXXXXXXXXXXXX  XXXXXXXXXX
XXXXXXXXXXXXXXX XXXXXXXXXXXXXXXXXX XXXXXXXXXXXX X        XXX
XX XXXXXXXXXXXX          XXXXXXXXX  XXXXXXXXXX  XXXXXXXXXXXX
XX  XXXXXXXXXXXX XXXXXXXXXXXXXXXXXX XXXXXXXX   XXXXXXXXXXXXX
XXX   XXXXXXXXXX XXXXXXXXXXXXXXXXXX XXXXXX   XXXXXX XXXXXXXX
XXXXX  XXXXXXXXX XXXXXXXXXXXXXX             XXXXXX  XX      
XXXXXXX  XXXXXXX XXXXXXXXXXXXXX XXXXXXXXXXX XXXXXX     XXXXX
XXXXX            XXXXXXXXXXXXXX XXXXXXXXXX  XXXXXX XXXXXXXXX
XXXXXX XXXXXXXXX XXXXXXXXXXXXXX XXXXXXXXXX XXXXXXX       XXX
XXXXXX  XXXXXXXX           XXXX XXXXXXXXXX XXXXXXX XXXXX   X
XXXXXXX XXXXXXXXX XXXXXXXXXXXXX XXXXXXXXXX XXXXXX  XXXXXXXXX
XXXXXXX       XXX  XXXXXXXXXXXX XXXXXXXXXX        XXXXXXXXXX
XXXXXXX XXXXX    X   XXXXXXXXXX XXXXXXXXXXXXXXXXXXXXXXXXXXXX
XXXXXXX XXXXXXXX XXX   XXXXXXXX XXXXXXXXXXXXXXXXXXXXXXXXXXXX
XXXXXXX XXXXXXXXXXXXXX   XXXXXX XXXXXXXXXXXXXXXXX   XXXXXXXX
XXXX    XXXXXXXXXXXXXXXX  XXXXX XXXXXXXX          X  XXXXXXX
XX   XX XXXXXXXXXXXXXXXXX   XXX          XXXXXX XXXX  XXXXXX
XX  XXX XXXXXXXXXXXXXXXXX X  XXXXXXXXXXXXXXXXX  XXXXX  XXXXX
XXX XXX  XXXXXXXXXXXXXXXX XX   XXXXXXXXXXXXXXX XXXXXXX  XXXX
XXX XXXX           XXXXXX XXXX   XXXXXXXXXXXXX XXXXXXXX XXXX
XXX  XXXXXXXXXXXXXXXXXXXX XXXXXX    XXXX       XXXXXXXX XXXX
XXXX XXXXXXXXXXXXXXXXXXXX XXXXXXXXX      XXXXXXXXXXXXXX  XXX
XXXX   XXXXXXXXXXXXXXXXXX XXXXXXXXXXXXXXXXXXXXXXXXXXXXXX XXX
XXXXXX              XXXXX   XXXXXXXXXXXXXXXXXXXXXXXXXXXX XXX
XXXXXXXXXXXXXXXXXXXXXXXXXXX           XXXXXXXXXXXXXXXXXX XXX
XXXXXXXXXXXXXXXXXXXXXXXXXXXXXXXXXXXXXXXXXXXXXXXXXXXXXXXX   D