8 
20 
  XXXXXXXXX   X   XX 
X XXXXXXXXX X   X XX 
X   XXXXXXX X X X XX 
XXX XXXXXX  X XXX XX 
XXX    XX     X     
XXX XX X  XXXXX XXX 
XXXXXX X XXXXXX   X 
XXXXXX   XXXXXX XXXD 